####################
#S  #    #    #    #
### # ## # ## # ## #
#   # #  # #  # #  #
# ### # ## # ## # ##
#     #    #    #  #
####### ########## #
#       #          #
# ####### ######## #
#       # #        #
####### # # ###### #
#       #   #      #
# ######### # #### #
# #         # #    #
# # ######### # ## #
# # #         #    #
# # # ######### ## #
# #   #            #
#  ####  ########  #
#                 E#
####################
