##############################
#S    #         #            #
# ### # ####### # ########## #
# #   #       # #          # #
# # ######### # ########## # #
# #           #            # #
# ########### ############ # #
# #         #              # #
# # ####### # ############ # #
# # #     # # #   #        # #
# # # ### # # # # # ####### ##
# # # # # # # # # #        # #
# # # # # # # # # ######## # #
# #   # # #   # #          # #
# ##### # ##### ############ #
#       #     #              #
####### ##### # ##############
#           # #              #
# ########### # ############ #
# #         # #            # #
# # ####### # # ########## # #
# # #       # # #          # #
# # # ##### # # # ########## #
# # # #   # # # #            #
# # # # # # # # # ########## #
# # # # # #   # # #          #
# # # # # ##### # # ######### #
# #   # #       # #          #
# ##### ######### ########## #
#                            E#
##############################
