##########
#S#     E#
# # ### ##
#   #    #
##### ## #
#        #
# ########
#        #
######## #
#        #
##########
